R 1920 1080
NO ./images/north.png
SO ./images/south.png
WE ./images/west.png
EA ./images/east.png
S ./images/barrel.png
F 220,100,0
C 225,30,255

11111111111111111111111111111
10000000100000000000000000001
10000000100000000000002000001
10000000100000000000000000001
100000001000000W0000000000001
10000000000000000000000000001
10000000100000000000000200001
10000000100000000000000000001
11111111111111111111111111111